1111111111111111
10000C000000P001
1000000100000001
100000010000C001
100C00000000E001
1111111111111111