111111111111111111111111111111111111111111111111111111111111
1E00000000000000M00000000000000000000000000000000000000000E1
100000000000000000000000000000000000000000000000000000000001
100000000000000000000000000000000000000000000000000000000001
100000000C00000000000000000000000000000000000000000000000001
100000000000000000000M00000000000000000000000000000000000001
100000000000000000000000000000000000000000000000000000000001
10000000000M000000000000000000000000000000000000000000000001
10000000000000000000000000000000000M000000000000000000000001
100000000000000000000000000000000000000000000000000000000001
100000000000P0000000000000000000000C000000000000000000000001
100000000000000000000000000000000000000000000000000000000001
100000000000000000000000000000000000000010000000000000000001
10000000000000000000C000000000000000000010000000000000000001
100000000000000000000000000000000000000010000000000000000001
1000000000000000M0000000000000000000000010000000000000000001
1000000000M001111100000000000000000000001000000000M000000001
100000000000000000000000000000000000000010000000000000000001
10000000000000000M0000000000000000000000C0000000000000000001
10000000000000M000000000000000000000000000000000000000000001
1C000000000000000M00000000000000000000M000000000000000000001
1000000000000000000000000000000000000000000000000000000C00E1
111111111111111111111111111111111111111111111111111111111111
