111111111111111111111111111111111111111111
100000000000000000000001111111000000000001
100000000000000000000111111111111100000001
100000000000000000011111111111111111000001
100000000000000001111111111111111111000001
100000000000000011111111111111111110000001
100000000000000011111111111111111110000001
100000000000000011111111111111111110000001
100000000000000111111111111111111100000001
100000000000111111111111111111111100000001
100000000011111111111111111111111100000001
100000000011111111111111111111111000000001
100000000000111111111111111111111000000001
100000000000011111111111111111111000000001
100000000000011111111111111111110000000001
100000000000111111111111111111110000000001
100000000000111111111111111111110000000001
100000000001111111111111111111111000000001
100000000001111111111111111111111100000001
100000000000000111111111111111111111110001
100000000000000000111111111111111111111001
100000000000000000111111111111111111111101
100000000000000001111111111111111111111101
100000000000000001111111111111111111111101
1PCE00000000000000001111111111111110000001
111111111111111111111111111111111111111111